00002222222220000000000000
02222111111122200022222000
02111111111111222211112200
02111111111111121111111220
22111111111111121111111120
21111111111111121111111120
33111111111111111111111120
33311111111111121111111120
33331111111111122211111220
33331111111111111222222200
33333111111111111111112220
33333111111111111111111120
33333111111111111111111120
23331111111111111111111120
22221111111111111111111120
00022211111111111111111220
00000222111111111122222200
00000002221112222220000000