55555555555555555555555555
55555555555555555555555555
55555555555555555555555555
55555555555555555555555555
55555555555555555555555555
55555555555555522222222222
33555555555555525555555552
33355555555555525555555552
33335555555555555555555552
33335555555555555555555552
33333555555555525555555552
33333555555555525555555552
33333555555555522222222222
53335555555555555555555555
55555555555555555555555555
55555555555555555555555555
55555555555555555555555555
55555555555555555555555555