22222222222222222222222222
21111111111111111111111112
21111111111111111111111112
21111111111111111111111112
21111111111111111111111112
21111111111111111111111112
21111111111111111111111112
21111111111111111111111112
21111111111111111111111112
21111111111111111111111112
21111111111111111111111112
21111111111111111111111112
21111112222222222222111112
21111112111111111112111112
21111112111111111112111112
21111112111111111112111112
21111112111111111112111112
22222222222222222222222222