0,0,0,0,2,5,5,5,5,5,5,5,1,0,0,0,0,0,0,0,0,0,0,0,0,0
0,2,5,5,3,0,0,0,0,9,0,0,4,5,1,0,0,0,0,0,0,0,0,0,0,0
0,7,0,0,0,0,0,0,0,0,0,0,0,0,4,1,0,0,0,0,0,0,0,0,0,0
0,7,0,0,0,0,0,0,0,0,0,0,8,0,0,4,1,0,0,0,0,0,0,0,0,0
2,3,0,0,0,0,0,0,0,0,8,8,8,8,0,0,6,0,0,0,0,0,0,0,0,0
3,0,0,0,0,0,0,0,0,8,8,8,8,8,0,0,6,0,0,0,0,0,0,0,0,0
0,0,0,0,0,0,0,0,0,0,8,8,0,8,0,0,6,0,0,0,0,0,0,0,0,0
0,0,0,0,0,0,0,0,0,0,8,8,8,0,0,0,6,0,0,0,0,0,0,0,0,0
0,0,0,0,0,0,0,0,0,0,0,0,0,0,0,0,4,1,0,0,0,0,0,0,0,0
0,0,0,0,0,0,0,0,0,0,0,0,0,0,0,0,0,4,5,5,5,5,1,0,0,0
0,0,0,0,0,0,0,0,0,0,0,0,0,0,0,0,0,0,0,0,0,0,4,5,1,0
0,0,0,0,0,0,0,0,0,0,0,0,0,0,0,0,0,0,0,0,0,0,0,0,6,0
0,0,0,0,0,0,0,0,0,0,0,0,0,0,0,0,0,0,0,0,0,0,0,0,6,0
0,0,0,0,0,0,0,0,0,0,0,0,0,0,0,0,0,0,0,0,0,0,0,0,6,0
0,0,0,0,0,8,8,8,0,8,0,0,0,0,0,0,0,0,0,0,0,0,0,0,6,0
0,0,0,0,8,0,0,8,8,8,8,8,0,0,0,0,0,0,0,0,0,0,0,0,6,0
0,0,8,8,0,8,8,8,0,8,0,0,8,0,0,8,0,0,0,0,0,0,0,0,4,5
0,8,0,8,8,8,8,8,8,8,8,8,0,0,8,0,0,0,0,0,0,0,0,0,0,0